0,0,0,0,0,0,0,0,0,0,0,0,0,0,0,0
0,0,0,0,0,0,0,2,1,1,1,2,0,0,0,0
0,0,0,0,0,0,0,1,0,0,0,1,0,0,2,2
0,0,0,0,0,0,0,1,0,0,0,1,0,0,1,0
3,1,1,1,1,1,1,2,0,0,0,2,1,1,2,0
0,0,0,0,0,0,0,1,0,0,0,1,0,0,1,0
0,0,0,0,0,0,0,1,0,0,0,1,0,0,2,2
0,0,0,0,0,0,0,2,1,1,1,2,0,0,0,0
0,0,0,0,0,0,0,0,0,0,0,0,0,0,0,0
routes
15,6,LULDLUL
15,2,LDLULDL